OOOXXXXXXWOOO
OOOXXXWBXXOOO
OOOWWBWXXWOOO
OOOXXXXXBXOOO
WXWWXWWXXXXXW
XBXXBXWBWWWBW
XXXXXXXXWWXXW
XWXBWXWXXBXXW
XXXXXXXXXWXXW
PXBXXXXXXWWBW
XXWXWBWXBXXXW
XWXXWXWWXWXXX
XXXBXXXXXXXBX
XXWWXXBXXWWXX
OOOXXWWXXWOOO
OOOXXWXXXXOOO
OOOWXXXBXWOOO
OOOWWWXXWWOOO